R 410 256
WE images/koto_west.xpm
NO images/koto_north.xpm
EA images/koto_east.xpm
S images/koto_sprite.xpm
C 255,0,0
F 1,255,0
SO images/koto_south.xpm










111111111111
1          1
100000000001
100000S00001
100000000111
100000000001
111111111111