R 910 556
WE images/koto_west.xpm
NO images/koto_north.xpm
EA images/koto_east.xpm
S images/koto_sprite.xpm
C 25,151,235
F 81,155,80
SO images/koto_south.xpm










111111111111
1          1
100000000001
100000S00001
100000000111
100000000001
111111111111