R 999 599
WE images/koto_west.xpm
NO images/koto_north.xpm
EA images/koto_east.xpm
SO images/koto_south.xpm
C 25,151,235
F 81,155,80
S images/koto_sprite.xpm




1111111111
1220 0 0S1
1000020001
1002000201
1000020001
1002000201
1000020001
1002000201
1111111111
