R 999 599
WE images/koto_west.xpm
NO images/koto_north.xpm
EA images/koto_east.xpm
S images/koto_sprite.xpm
C 25,151,235
F 81,155,80
SO images/koto_south.xpm







1111111111111111111111111111111111111111111111111111111111111111111111111111111
1                                                                    2  2 22  1
1000000000000000000000000000000000000000000000000000000000000000000000000022221
1000000000000000000000000000000000000000000000000000000000000000000002 00200221
1                                                                    2  2 22  1
1000000000000000000000000000000000000000000000000000000000000000000000000022221
1000000000000000000000000000000000000000000000000000000000000000000002 00200221
1                                                                    2  2 22  1
1000000000000000000000000000000000000000000000000000000000000000000000000022221
1000000000000000000000000000000000000000000000000000000000000000000002 00200221
1                                                                    2  2 22  1
1000000000000000000000000000000000000000000000000000000000000000000000000022221
1000000000000000000000000000000000000000000000000000000000000000000002 00200221
1                                                                    2  2 22  1
1000000000000000000000000000000000000000000000000000000000000000000000000022221
1000000000000000000000000000000000000000000000000000000000000000000002 00200221
1                                                                    2  2 22  1
1000000000000000000000000000000000000000000000000000000000000000000000000022221
1000000000000000000000000000000000000000000000000000000000000000000002 00200221
1                                                                    2  2 22  1
1000000000000000000000000000000000000000000000000000000000000000000000000022221
1000000000000000000000000000000000000000000000000000000000000000000002 00200221
1                                                                    2  2 22  1
1000000000000000000000000000000000000000000000000000000000000000000000000022221
1000000000000000000000000000000000000000000000000000000000000000000002 00200221
1                                                                    2  2 22  1
1000000000000000000000000000000000000000000000000000000000000000000000000022221
1000000000000000000000000000000000000000000000000000000000000000000002 00200221
1                                                                    2  2 22  1
1000000000000000000000000000000000000000000000000000000000000000000000000022221
1000000000000000000000000000000000000000000000000000000000000000000002 00200221
1                                                                    2  2 22  1
1000000000000000000000000000000000000000000000000000000000000000000000000022221
1000000000000000000000000000000000000000000000000000000000000000000002 00200221
1                                                                    2  2 22  1
1000000000000000000000000000000000000000000000000000000000000000000000000022221
1000000000000000000000000000000000000000000000000000000000000000000002 00200221
1                                                                    2  2 22  1
1000000000000000000000000000000000000000000000000000000000000000000000000022221
1000000000000000000000000000000000000000000000000000000000000000000002 00200221
1                                                                    2  2 22  1
1000000000000000000000000000000000000000000000000000000000000000000000000022221
1000000000000000000000000000000000000000000000000000000000000000000002 00200221
1                                                                    2  2 22  1
1000000000000000000000000000000000000000000000000000000000000000000000000022221
1000000000000000000000000000000000000000000000000000000000000000000002 00200221
1                                                                    2  2 22  1
1000000000000000000000000000000000000000000000000000000000000000000000000022221
1000000000000000000000000000000000000000000000000000000000000000000002 00200221
1                                                                    2  2 22  1
1000000000000000000000000000000000000000000000000000000000000000000000000022221
1000000000000000000000000000000000000000000000000000000000000000000002 00200221
1                                                                    2  2 22  1
1000000000000000000000000000000000000000000000000000000000000000000000000022221
1000000000000000000000000000000000000000000000000000000000000000000002 00200221
1                                                                    2  2 22  1
1000000000000000000000000000000000000000000000000000000000000000000000000022221
1000000000000000000000000000000000000000000000000000000000000000000002 00200221
1                                                                    2  2 22  1
1000000000000000000000000000000000000000000000000000000000000000000000000022221
1000000000000000000000000000000000000000000000000000000000000000000002 00200221
1                                                                    2  2 22  1
1000000000000000000000000000000000000000000000000000000000000000000000000022221
1000000000000000000000000000000000000000000000000000000000000000000002 00200221
1                                                                    2  2 22  1
1000000000000000000000000000000000000000000000000000000000000000000000000022221
1                                                                    2  2 22  1
1000000000000000000000000000000000000000000000000000000000000000000000000022221
1000000000000000000000000000000000000000000000000000000000000000000002 00200221
1                                                                    2  2 22  1
1000000000000000000000000000000000000000000000000000000000000000000000000022221
1000000000000000000000000000000000000000000000000000000000000000000002 00200221
1                                                                    2  2 22  1
1000000000000000000000000000000000000000000000000000000000000000000000000022221
1000000000000000000000000000000000000000000000000000000000000000000000000022221
1000000000000000000000000000000000000000000000000000000000000000000002 00200221
100000000000000000000000000000000000000000000000000000000000000000000222N220211
1000000000000000000000000000000000000000000000000000000000000000000000022022021
1111111111111111111111111111111111111111111111111111111111111111111111111111111