R 6354280 38335523 
WE west.com
NO north.com
EA east.com
S sprite.com
F 4,65,1

C 5,1,2
SO south....com

1111111
10S0201
1020 01
1000001
120011
1022221
1111111