R 512 256
WE images/koto_west.xpm
NO images/koto_north.xpm
EA images/koto_east.xpm
S images/koto_sprite.xpm
C 0,0,255
F 0,255,0
SO images/koto_south.xpm

1111111
1000201
1020 01
1222221
120 N11
1022221
1111111