R 912 556
WE images/koto_west.xpm
NO images/koto_north.xpm
EA images/koto_east.xpm
S images/koto_sprite.xpm
C 0,0,255
F 0,255,0
SO images/koto_south.xpm










11111
12  1
12 01
12  1
12  1
12  1
12 11
1E221
11111